

NO         ./path_to_the_north_texture



SO ./path_to_the_south_texture fchgch

WE ./path_to_the_west_texture   klk1351


EA     ./path_to_the_east_texture


F      220,100,0   j
C 225,30,0

0000000
1111111111111111111111111111111
10000000000000000000000000000001111011
100000000000000000000000000000001
1111111111111111D1111111111S11111
             10001              1
             111111
