NO ./path_to_the_north_texture
SO ./path_to_the_south_texture fchgch

WE ./path_to_the_west_texture   klk1351


EA     ./path_to_the_east_texture


F      220,100,0   j
C 225,30,0

1111111111111111111111111111111
100000000000000000000000000000011
1000000000000000000000000000000001
111111111111111111111111111111111
